########################################################################################################################################################################################################
#                                                                                                                                                                                                      #
#                                                                                                                                                                                                      #
#      C           C           C           C           C           C           C           C           C           C           C           C           C           C           C           C          #
#                                                                                                                                                                                                      #
#                                                                                                                                                                                                      #
#                                                                                                                                                                                                      #
#                C                   C                   C                   C                   C                   C                   C                   C                   C                   #
#                                                                                                                                                                                                      #
#          |                   |                   |                   |                   |                   |                   |                   |                   |                          #
#          |     C             |     C             |     C             |     C             |     C             |     C             |     C             |     C             |     C                    #
#          |                   |                   |                   |                   |                   |                   |                   |                   |                          #
#          |           ########|##########         |           ########|##########         |           ########|##########         |           ########|##########         |                         #
#                              |                                       |                                       |                                                                                     #
#                              |     C                                 |     C                                 |     C                                     C                                        #
#                              |                                       |                                       |                                                                                    #
#S C   C   C   C   C   C   C  |  C   C   C   C   C   C   C   C   C  |  C   C   C   C   C   C   C   C   C  |  C   C   C   C   C   C   C   C   C   C    C   C   C   C   C   C   C   C   C   C      #
#                                                                                                                                                                                                      #
########################################################################################################################################################################################################
########################################################################################################################################################################################################